1111111
100E001
1P01001
1010CC1
1111111