1111111
100E001
1001101
1010C01
1111111