
1111111
10C00E1
1001101
1P0C001
1111111