1111111111111111
10010000000C0001
1000011111000001
1P0011E000000001
1111111111111111