
111111111111111111111111111111111111111
1000000010C0100000000C10001000100010001
101010101010101011111010101010101010101
101010101010101010001010101010101010101
101010101010101010P01010101010101010101
101C1C100010001C10000C10101010101010101
101111111111111111111110101010101010101
10C0C0C0C0C0C0C0C0C0C0C01000100010001E1
111111111111111111111111111111111111111