11111111111111111
1E000000001000001
10011011101011101
10101000101000101
10101110101110101
1C100010001000101
11111111101111101
10000000001000001
10111111111011101
10100000C0001C101
10101111111110101
10101000000010001
10101011111010P11
1C001010001010001
11111111111111111